보고서 작성하기	업무
이메일 확인하기	업무
회의 준비하기	업무
프로젝트 계획 수립	업무
고객 미팅	업무
문서 정리하기	업무
업무 일정 관리	업무
전화 상담하기	업무
프레젠테이션 준비	업무
업무 관련 연구하기	업무
장보기	개인
병원 방문	개인
집 청소하기	개인
가족 모임	개인
친구 만나기	개인
은행 업무 보기	개인
개인 일정 관리	개인
취미 활동하기	개인
휴식 취하기	개인
개인 용품 구매	개인
헬스장 가기	운동
조깅하기	운동
요가 수업	운동
수영하기	운동
등산가기	운동
자전거 타기	운동
홈트레이닝	운동
스트레칭하기	운동
테니스 치기	운동
축구 경기	운동
온라인 강의 듣기	학습
책 읽기	학습
외국어 공부하기	학습
코딩 연습하기	학습
자격증 공부	학습
논문 읽기	학습
스터디 그룹 참여	학습
새로운 기술 배우기	학습
전문 서적 읽기	학습
온라인 튜토리얼 보기	학습
영화 보기	여가
음악 감상하기	여가
게임하기	여가
여행 계획 세우기	여가
공원 산책하기	여가
TV 시청하기	여가
요리하기	여가
그림 그리기	여가
악기 연주하기	여가
친구와 대화하기	여가
PC방 가기 여가영화 감상하기	여가
독서하기	여가
음악 듣기	여가
공원 산책하기	여가
TV 시리즈 시청하기	여가
게임하기	여가
친구와 커피 마시기	여가
요리하기	여가
정원 가꾸기	여가
그림 그리기	여가
퍼즐 맞추기	여가
보드게임 즐기기	여가
악기 연주하기	여가
DIY 프로젝트 하기	여가
온라인 쇼핑하기	여가
블로그 작성하기	여가
사진 촬영하기	여가
요가 하기	여가
명상하기	여가
팟캐스트 듣기	여가
낮잠 자기	여가
애완동물과 놀기	여가
전시회 관람하기	여가
콘서트 가기	여가
캠핑 가기	여가
등산하기	여가
자전거 타기	여가
수영하기	여가
요리 클래스 참여하기	여가
온라인 게임하기	여가
